1*10111111101111111
1010000000010000001
1000101011010111101
1101000011010011011
1001010010011001101
0101010101110000111
1011110111111011111
1010010000010000111
1000101001010110001
1101000100011000111
1001000000000000111
0101010101#11111111