1*1111111111
101000000001
100010101101
110100000001
100101010111
010101010011
100101111011
101001000001
100010101101
111010000001
100100000001
11111111#111