1*11111111
1000100001
1101101111
1000000001
1111111#11