11111111111111111
10101000000100001
10001010110001101
11010000111111001
11010100000001001
11010101011101011
10010101110101011
*0100101000001001
10001000010110001
11011011110010111
10000000000110001
11111111111111#11