1*1011111110
101000000001
100010101101
110100001101
100101001001
010101010111
101111011111
101001000001
100010100101
110100010001
100100000001
0101010101#1